反常的天气=thời tiết bất thường
承担后果=gánh chịu hậu quả
遵守合同=tuân thủ hợp đồng
怪异的行为=hành vi kỳ quái; hành vi kỳ quặc; hành vi kỳ lạ
取消禁令=dỡ bỏ lệnh cấm
很有胆量=có thừa can đảm
浑身是胆=có thừa can đảm
及时了解最新进展情况=cập nhật kịp thời diễn biến sự việc
不作评论=từ chối bình luận
荒唐的要求=đòi hỏi vô lý
列举了大量的例证=đưa ra nhiều dẫn chứng
充足的阳光=ánh sáng dồi dào
不要胡闹=Đừng có lố bịch thế
适应新的情况=thích ứng (thích nghi) với tình hình mới
同案犯=đồng phạm
对自己的工作负责=có trách nhiệm với công việc của mình
负有部分责任=chịu một phần trách nhiệm; chịu trách nhiệm một phần
承担全部责任=chịu mọi trách nhiệm
占绝对优势=chiếm ưu thế tuyệt đối
熟悉新工作=làm quen với công việc mới
对市场了如指掌=hiểu rõ thị trường
出色地完成任务=hoàn thành xuất sắc nhiệm vụ
对工作入迷=đam mê công việc
沉溺于赌博=ham cờ bạc; nghiện cờ bạc; máu đỏ đen
食品添加剂=chất phụ gia thực phẩm
食用色素=màu thực phẩm
防冻剂=thuốc chống đông; chất chống đông
填充剂=chất làm đầy (filer)
坚持观点=giữ nguyên quan điểm; giữ vững lập trường
紧紧地追随=bám sát; bám đuôi; theo sát
有助于身体健康=tốt cho sức khỏe
孝顺父母=có hiếu với cha mẹ
在逆境中=nghịch cảnh; hoàn cảnh éo le
充沛的雨水=lượng mưa dồi dào
承受可怕的后果=hứng chịu hậu quả đáng sợ
病情恶化=bệnh ngày một nghiêm trọng; bệnh ngày càng trở nặng
搅拌水泥=trộn hồ; trộn vữa
宜人的天气=thời tiết dễ chịu
悦耳的声音=chất âm dễ nghe, êm tai
轻微的病=bệnh nhẹ
严重的病=bệnh nặng
经济失调=mất cân đối kinh tế
减轻疼痛=giảm đau
经济危机=khủng hoảng kinh tế
分配红利=chia hoa hồng
赔偿损失=bồi thường thiệt hại
弥补过失=bù đắp sai lầm
温柔性格=tính cách dịu dàng
时间充裕=thời gian dư dả
食物中毒=ngộ độc thực phẩm
